#####################
#A    ##########    #
# ###         ##### #
# ### #######  #### #
# ### ##### ##  ### #
#           ###  ## #
# ## ##### #####  # #
# ## ##### ######## #
# ## #####          #
# ## ############## #
#     B## #         #
## ###### ########  #
##                 ##
#####################