A     ############  #
#####         ##### #
##### #######  #### #
##### #### ###  ### #
####       ####  ## #
#### ##### #####  # #
#### ##### ######## #
###  #####          #
##  ############### #
##        ####      #
#### ####      #### #
      ############  #
#####               #
########## ##  #### #
##### #### ###  ### #
####       ####  ## #
#### ##### #####  # #
#### ##### ##### ## #
###  #####          #
##  #####  ##########
##         ###      B
### #####      #### 
### 
#####################